allele,<,=,>,mass_spec,total
BoLA-6*13:01,3,7,0,0,10
BoLA-HD*06:01,0,6,0,0,6
Eqca-1*01:01,0,68,0,2,70
Eqca-1*02:01,0,4,0,4,8
Eqca-16*01:01,0,4,0,4,8
H-2-Db,48,293,55,943,1339
H-2-Dd,2,34,10,0,46
H-2-Kb,56,335,48,2088,2527
H-2-Kd,30,75,39,740,884
H-2-Kk,17,38,2,0,57
H-2-Ld,13,25,12,0,50
HLA-A*01:01,989,304,116,6250,7659
HLA-A*02:01,2952,691,289,11101,15033
HLA-A*02:02,6,250,28,0,284
HLA-A*02:03,1,409,98,1833,2341
HLA-A*02:05,1,6,1,300,308
HLA-A*02:06,1,350,89,1,441
HLA-A*02:07,0,6,4,3345,3355
HLA-A*02:11,1,91,18,0,110
HLA-A*02:12,0,107,12,0,119
HLA-A*02:16,0,79,14,0,93
HLA-A*02:17,0,35,0,0,35
HLA-A*02:19,0,102,24,0,126
HLA-A*02:50,0,13,1,0,14
HLA-A*03:01,6646,529,107,3951,11233
HLA-A*03:19,0,4,0,0,4
HLA-A*11:01,872,463,83,2955,4373
HLA-A*23:01,595,208,48,131,982
HLA-A*24:02,446,213,100,5544,6303
HLA-A*24:03,0,97,13,0,110
HLA-A*25:01,459,94,3,57,613
HLA-A*26:01,58,293,98,433,882
HLA-A*26:02,0,51,14,0,65
HLA-A*26:03,0,36,19,0,55
HLA-A*29:02,118,224,36,6107,6485
HLA-A*30:01,39,174,145,74,432
HLA-A*30:02,8,148,62,17,235
HLA-A*31:01,1197,496,55,1273,3021
HLA-A*32:01,304,101,14,648,1067
HLA-A*32:07,0,9,0,0,9
HLA-A*32:15,0,8,0,0,8
HLA-A*33:01,0,324,31,21,376
HLA-A*66:01,1,6,3,42,52
HLA-A*68:01,5744,344,74,39,6201
HLA-A*68:02,0,367,62,1991,2420
HLA-A*68:23,0,9,0,0,9
HLA-A*69:01,0,185,27,0,212
HLA-A*80:01,0,116,1,0,117
HLA-B*07:01,6,10,5,4740,4761
HLA-B*07:02,3259,285,120,9367,13031
HLA-B*08:01,1600,213,86,1886,3785
HLA-B*08:02,0,38,65,0,103
HLA-B*08:03,0,27,21,0,48
HLA-B*14:01,0,5,0,0,5
HLA-B*14:02,60,10,8,275,353
HLA-B*15:01,494,284,51,7728,8557
HLA-B*15:02,1,17,0,137,155
HLA-B*15:03,0,61,10,0,71
HLA-B*15:09,2,39,44,0,85
HLA-B*15:17,0,142,4,0,146
HLA-B*15:42,0,36,1,5,42
HLA-B*18:01,883,246,27,1222,2378
HLA-B*27:02,2,3,1,3251,3257
HLA-B*27:03,1,85,5,1012,1103
HLA-B*27:04,3,3,3,1276,1285
HLA-B*27:05,1057,230,71,54067,55425
HLA-B*27:06,2,6,0,1215,1223
HLA-B*27:20,0,9,0,0,9
HLA-B*35:01,1745,171,133,2375,4424
HLA-B*35:03,1108,7,21,192,1328
HLA-B*37:01,221,4,5,67,297
HLA-B*38:01,62,35,18,56,171
HLA-B*39:01,244,140,25,1750,2159
HLA-B*39:06,980,5,0,4,989
HLA-B*40:01,1783,199,63,3164,5209
HLA-B*40:02,725,82,25,7599,8431
HLA-B*40:13,0,7,0,0,7
HLA-B*42:01,0,12,10,10,32
HLA-B*44:02,2187,188,34,4760,7169
HLA-B*44:03,464,120,28,4534,5146
HLA-B*45:01,1245,83,27,682,2037
HLA-B*45:06,0,37,0,0,37
HLA-B*46:01,1,179,4,2014,2198
HLA-B*48:01,0,87,2,0,89
HLA-B*51:01,80,241,49,3411,3781
HLA-B*53:01,2,144,33,1,180
HLA-B*54:01,0,99,22,1207,1328
HLA-B*57:01,86,273,13,12165,12537
HLA-B*57:03,1,3,0,0,4
HLA-B*58:01,5,222,100,2,329
HLA-B*58:02,1,5,0,0,6
HLA-B*73:01,99,14,0,176,289
HLA-B*83:01,0,33,1,0,34
HLA-C*03:03,249,18,0,1143,1410
HLA-C*04:01,50,53,0,2028,2131
HLA-C*05:01,385,16,0,4381,4782
HLA-C*06:02,103,29,7,2437,2576
HLA-C*07:02,647,14,3,1242,1906
HLA-C*08:02,5,9,0,3442,3456
HLA-C*12:03,0,18,0,1397,1415
HLA-C*14:02,173,20,0,2442,2635
HLA-C*15:02,0,19,0,1908,1927
HLA-E*01:03,0,6,2,0,8
Mamu-A*01:01,15,195,50,0,260
Mamu-A*02:01,9,110,18,0,137
Mamu-A*02:0102,0,14,1,0,15
Mamu-A*07:01,0,51,18,0,69
Mamu-A*07:0103,0,10,1,0,11
Mamu-A*11:01,2,108,17,0,127
Mamu-A*22:01,4,50,16,0,70
Mamu-A*26:01,0,15,7,0,22
Mamu-B*01:01,2,74,14,0,90
Mamu-B*03:01,0,88,27,0,115
Mamu-B*08:01,0,81,32,872,985
Mamu-B*10:01,1,15,1,0,17
Mamu-B*17:01,0,130,35,0,165
Mamu-B*17:04,0,130,1,0,131
Mamu-B*39:01,1,45,1,0,47
Mamu-B*52:01,3,83,4,0,90
Mamu-B*66:01,3,8,0,0,11
Mamu-B*83:01,0,37,7,0,44
Mamu-B*87:01,1,15,1,0,17
Patr-A*01:01,3,33,10,0,46
Patr-A*03:01,0,30,9,0,39
Patr-A*04:01,0,26,8,0,34
Patr-A*07:01,4,44,14,0,62
Patr-A*09:01,1,63,3,0,67
Patr-B*01:01,1,64,15,0,80
Patr-B*13:01,2,19,4,0,25
Patr-B*24:01,0,32,1,0,33
